Countries,Continent,All Medals,Winter Medals,Gold Medals,Silver Medals,Bronze Medals,Male,Female,100m Sprint,Archery,High Jump,100m Swimming,Javelin,Individual Sports,Team Sports,Medals per Capita
Aruba,North America,77,184,57,10,10,0,77,4,1,3,6,8,51,26,723.0
Afghanistan,Asia,121,186,22,27,72,29,92,7,6,2,2,4,54,67,3.0
Angola,Africa,131,21,40,23,68,126,5,5,1,5,4,7,129,2,4.0
Albania,Europe,127,199,72,49,6,82,45,9,9,1,1,9,57,70,46.0
Andorra,Europe,136,171,70,25,41,2,134,6,5,6,4,7,120,16,1704.0
Arab World,Asia,155,9,65,29,61,126,29,5,2,8,8,8,93,62,0.0
United Arab Emirates,Asia,157,9,70,20,67,77,80,2,6,0,4,5,79,78,17.0
Argentina,South America,78,183,49,29,0,20,58,6,4,8,6,4,77,1,2.0
Armenia,Asia,103,86,64,31,8,53,50,5,4,9,2,2,15,88,37.0
American Samoa,Oceania,179,15,35,72,72,174,5,2,3,0,7,1,164,15,4043.0
Antigua and Barbuda,North America,66,26,17,7,42,33,33,9,1,0,8,4,18,48,704.0
Australia,Oceania,217,128,90,40,87,43,174,2,8,9,8,7,122,95,8.0
Austria,Europe,127,181,21,60,46,68,59,8,5,4,0,7,31,96,14.0
Azerbaijan,Asia,184,21,83,9,92,104,80,8,7,4,2,6,3,181,18.0
Burundi,Africa,93,32,18,73,2,73,20,6,3,3,0,9,12,81,7.0
Belgium,Europe,159,190,71,71,17,53,106,2,8,9,3,4,78,81,14.0
Benin,Africa,95,22,21,4,70,83,12,7,5,7,0,0,76,19,7.0
Burkina Faso,Africa,161,162,77,82,2,25,136,6,0,9,9,0,104,57,7.0
Bangladesh,Asia,248,75,84,77,87,119,129,9,0,4,3,6,88,160,1.0
Bulgaria,Europe,79,130,65,14,0,17,62,1,6,4,3,0,66,13,12.0
Bahrain,Asia,37,1,17,2,18,31,6,3,8,5,1,5,27,10,25.0
"Bahamas, The",North America,158,110,81,58,19,10,148,1,9,4,0,7,49,109,385.0
Bosnia and Herzegovina,Europe,109,60,3,43,63,2,107,9,2,3,9,8,43,66,34.0
Belarus,Europe,159,40,1,97,61,69,90,5,2,1,7,3,70,89,17.0
Belize,North America,78,110,48,6,24,75,3,2,6,6,0,1,50,28,192.0
Bermuda,North America,107,169,32,74,1,106,1,5,2,0,7,7,87,20,1684.0
Bolivia,South America,126,57,75,30,21,82,44,5,3,5,9,0,94,32,10.0
Brazil,South America,148,181,96,50,2,123,25,4,6,7,7,4,52,96,1.0
Barbados,North America,156,120,22,75,59,97,59,3,3,7,2,0,126,30,554.0
Brunei Darussalam,Asia,92,146,15,28,49,10,82,5,6,5,2,8,39,53,205.0
Bhutan,Asia,161,81,72,21,68,11,150,1,5,1,9,3,8,153,206.0
Botswana,Africa,161,69,67,67,27,51,110,4,3,3,3,7,44,117,61.0
Central African Republic,Africa,119,178,22,40,57,79,40,2,9,7,5,4,106,13,21.0
Canada,North America,123,135,35,76,12,69,54,0,2,1,6,1,116,7,3.0
Central Europe and the Baltics,Europe,171,4,99,66,6,167,4,2,2,4,1,8,66,105,2.0
Switzerland,Europe,221,3,97,29,95,22,199,9,6,0,8,3,14,207,25.0
Channel Islands,Europe,178,89,71,81,26,139,39,5,7,8,0,2,120,58,1023.0
Chile,South America,41,136,5,4,32,31,10,2,5,7,6,4,1,40,2.0
China,Asia,67,131,58,6,3,63,4,7,4,2,9,2,60,7,0.0
Cote d'Ivoire,Africa,141,3,71,32,38,82,59,6,1,6,7,3,0,141,5.0
Cameroon,Africa,165,91,74,48,43,6,159,1,5,7,6,8,157,8,6.0
"Congo, Dem. Rep.",Africa,96,139,6,23,67,64,32,3,8,1,2,6,41,55,1.0
"Congo, Rep.",Africa,158,59,63,2,93,89,69,6,0,1,5,0,14,144,26.0
Colombia,South America,207,173,66,42,99,202,5,8,6,1,6,4,164,43,4.0
Comoros,Africa,274,101,92,89,93,150,124,3,0,3,7,8,159,115,327.0
Cabo Verde,Africa,253,152,85,99,69,67,186,1,4,2,1,0,168,85,427.0
Costa Rica,North America,155,107,13,50,92,3,152,4,2,1,3,7,150,5,30.0
Cuba,North America,180,132,90,48,42,126,54,4,6,4,5,8,94,86,16.0
Cayman Islands,North America,190,30,56,62,72,121,69,7,7,5,3,5,65,125,2765.0
Cyprus,Asia,92,74,2,64,26,72,20,1,6,7,9,2,21,71,74.0
Czechia,Europe,161,151,85,52,24,66,95,2,5,5,8,8,76,85,15.0
Germany,Europe,99,19,5,44,50,43,56,5,6,8,9,2,50,49,1.0
Djibouti,Africa,197,132,40,91,66,85,112,0,8,0,0,0,171,26,176.0
Dominica,North America,58,165,2,27,29,31,27,3,4,7,7,1,8,50,797.0
Denmark,Europe,119,148,92,9,18,12,107,6,0,4,8,8,110,9,20.0
Dominican Republic,North America,208,74,85,56,67,61,147,2,1,4,6,9,19,189,19.0
Algeria,Africa,241,155,92,62,87,68,173,1,1,8,0,4,148,93,5.0
Ecuador,South America,165,113,15,81,69,55,110,2,2,0,7,5,125,40,9.0
"Egypt, Arab Rep.",Africa,164,102,31,80,53,82,82,5,3,8,7,7,37,127,1.0
Eritrea,Africa,127,38,41,13,73,82,45,8,8,6,0,3,4,123,34.0
Spain,Europe,114,144,52,54,8,36,78,6,3,6,8,0,92,22,2.0
Estonia,Europe,146,97,45,31,70,91,55,1,9,7,5,8,37,109,109.0
Ethiopia,Africa,162,186,58,8,96,32,130,1,9,0,0,2,112,50,1.0
Finland,Europe,174,58,74,33,67,118,56,8,0,3,3,7,90,84,31.0
Fiji,Oceania,154,184,31,27,96,32,122,2,2,2,6,8,94,60,166.0
France,Europe,141,5,38,41,62,17,124,9,8,9,0,3,131,10,2.0
Faroe Islands,Europe,184,26,51,34,99,17,167,9,2,7,2,4,27,157,3466.0
Gabon,Africa,102,89,53,37,12,81,21,1,0,3,4,4,66,36,43.0
United Kingdom,Europe,155,144,93,47,15,151,4,7,5,6,9,6,37,118,2.0
Georgia,Asia,162,135,37,36,89,102,60,9,9,7,1,7,96,66,44.0
Ghana,Africa,61,15,36,16,9,34,27,8,9,6,1,6,36,25,2.0
Gibraltar,Europe,115,142,32,46,37,6,109,2,3,1,4,4,7,108,3522.0
Guinea,Africa,234,17,76,77,81,203,31,9,3,2,0,7,186,48,17.0
Guinea-Bissau,Africa,228,77,91,91,46,180,48,5,2,0,9,9,104,124,108.0
Equatorial Guinea,Africa,157,82,47,81,29,109,48,1,2,0,0,6,117,40,94.0
Greece,Europe,207,195,37,80,90,167,40,6,1,5,4,0,9,198,20.0
Grenada,North America,114,26,31,62,21,64,50,6,3,6,5,7,29,85,909.0
Greenland,North America,84,94,41,24,19,81,3,5,0,6,8,4,51,33,1483.0
Guatemala,North America,182,106,91,54,37,45,137,9,4,8,9,1,85,97,10.0
Guam,Oceania,154,168,26,63,65,112,42,6,4,8,5,0,50,104,897.0
Guyana,South America,119,193,75,2,42,82,37,9,7,7,9,8,103,16,147.0
"Hong Kong SAR, China",Asia,219,0,67,83,69,85,134,8,1,6,0,1,65,154,30.0
Honduras,North America,230,0,52,83,95,79,151,3,2,9,4,6,107,123,22.0
Croatia,Europe,161,62,95,1,65,142,19,3,9,9,6,3,134,27,42.0
Haiti,North America,41,13,0,16,25,24,17,4,3,1,7,4,14,27,4.0
Hungary,Europe,199,42,81,60,58,87,112,2,8,3,1,0,82,117,21.0
IDA total,Europe,155,125,37,97,21,102,53,3,0,2,2,0,88,67,0.0
IDA blend,Europe,231,99,58,86,87,205,26,5,2,0,4,5,76,155,0.0
Indonesia,Asia,137,91,84,3,50,81,56,7,9,9,6,0,89,48,0.0
IDA only,Europe,124,143,58,10,56,12,112,4,6,5,0,1,50,74,0.0
Isle of Man,Europe,246,37,91,77,78,189,57,1,0,9,9,8,121,125,2911.0
India,Asia,138,150,49,62,27,4,134,3,5,6,1,8,101,37,0.0
Ireland,Europe,249,99,95,76,78,96,153,3,5,0,9,8,221,28,49.0
"Iran, Islamic Rep.",Asia,143,179,54,14,75,33,110,9,4,1,0,4,24,119,2.0
Iraq,Asia,232,22,87,51,94,212,20,2,2,2,5,7,71,161,5.0
Iceland,Europe,42,119,15,19,8,5,37,6,9,5,6,6,10,32,110.0
Israel,Asia,259,148,78,93,88,199,60,1,1,4,0,7,177,82,27.0
Italy,Europe,196,12,95,21,80,3,193,1,8,4,2,2,135,61,3.0
Jamaica,North America,116,22,34,8,74,59,57,0,5,9,3,0,21,95,41.0
Jordan,Asia,130,111,26,74,30,58,72,9,1,3,9,9,25,105,12.0
Japan,Asia,110,186,52,4,54,56,54,4,2,7,2,2,83,27,1.0
Kazakhstan,Asia,157,65,87,37,33,143,14,1,0,8,5,7,95,62,8.0
Kenya,Africa,187,141,35,86,66,148,39,2,2,5,2,4,123,64,3.0
Kyrgyz Republic,Asia,174,113,52,91,31,65,109,7,5,2,5,2,59,115,26.0
Cambodia,Asia,144,151,28,35,81,108,36,1,1,3,6,4,143,1,9.0
Kiribati,Oceania,170,117,76,50,44,109,61,7,5,2,0,6,21,149,1295.0
St. Kitts and Nevis,North America,110,18,92,16,2,55,55,5,6,6,4,2,89,21,2308.0
"Korea, Rep.",Asia,144,57,26,55,63,64,80,9,8,2,5,6,28,116,3.0
Kuwait,Asia,136,186,87,30,19,61,75,4,5,3,7,0,10,126,32.0
Latin America & Caribbean (excluding high income),South America,83,197,2,72,9,54,29,4,9,2,3,3,75,8,0.0
Lao PDR,Asia,151,52,48,9,94,139,12,3,1,2,1,9,71,80,20.0
Lebanon,Asia,187,154,88,45,54,147,40,9,3,9,5,5,49,138,34.0
Liberia,Africa,102,115,21,11,70,82,20,3,9,4,1,6,1,101,19.0
Libya,Africa,211,54,82,99,30,151,60,7,9,4,7,8,158,53,31.0
St. Lucia,North America,212,195,32,83,97,198,14,8,2,6,9,3,191,21,1179.0
Latin America & Caribbean,South America,193,109,72,68,53,13,180,8,2,8,9,5,37,156,0.0
Liechtenstein,Europe,105,89,33,33,39,39,66,2,8,4,8,6,41,64,2670.0
Sri Lanka,Asia,67,7,11,0,56,48,19,6,6,0,2,1,41,26,3.0
Lesotho,Africa,102,182,1,18,83,31,71,3,5,2,4,7,34,68,44.0
Lithuania,Europe,267,37,98,70,99,59,208,5,1,4,5,9,53,214,94.0
Luxembourg,Europe,165,52,69,81,15,5,160,5,5,6,7,3,120,45,254.0
Latvia,Europe,111,186,9,31,71,24,87,8,1,2,3,6,45,66,59.0
"Macao SAR, China",Asia,136,111,13,50,73,98,38,2,7,1,2,4,25,111,196.0
St. Martin (French part),Europe,153,34,85,45,23,79,74,6,3,8,4,8,60,93,4813.0
Morocco,Africa,141,90,96,30,15,43,98,6,1,6,7,1,137,4,4.0
Monaco,Europe,138,126,66,52,20,127,11,8,6,0,0,5,41,97,3784.0
Moldova,Europe,160,150,44,52,64,65,95,1,1,1,6,3,82,78,62.0
Madagascar,Africa,202,175,96,31,75,50,152,3,5,8,4,0,52,150,7.0
Maldives,Asia,182,77,77,51,54,78,104,2,5,9,4,3,81,101,347.0
Middle East & North Africa,Africa,198,135,41,81,76,62,136,0,7,6,9,9,108,90,0.0
Mexico,North America,117,99,58,34,25,70,47,6,5,2,1,6,81,36,1.0
Marshall Islands,Oceania,145,91,14,99,32,2,143,2,2,4,3,3,4,141,3488.0
North Macedonia,Europe,190,80,85,18,87,34,156,9,8,4,9,7,97,93,92.0
Mali,Africa,201,102,51,87,63,126,75,3,4,7,3,6,57,144,9.0
Malta,Europe,92,197,68,21,3,38,54,7,1,3,4,1,77,15,176.0
Myanmar,Asia,38,153,10,2,26,19,19,6,0,6,9,0,9,29,1.0
Middle East & North Africa (excluding high income),Africa,205,93,75,65,65,140,65,1,3,4,3,7,54,151,0.0
Montenegro,Europe,176,0,87,65,24,19,157,7,3,2,7,4,22,154,286.0
Mongolia,Asia,64,33,18,11,35,56,8,2,2,7,5,3,53,11,19.0
Northern Mariana Islands,Oceania,166,188,60,77,29,48,118,6,4,2,2,3,160,6,3350.0
Mozambique,Africa,108,123,27,57,24,9,99,5,3,0,8,8,70,38,3.0
Mauritania,Africa,143,51,20,47,76,89,54,5,4,1,3,0,12,131,30.0
Mauritius,Africa,128,143,69,31,28,3,125,7,5,1,4,8,64,64,101.0
Malawi,Africa,156,95,23,37,96,60,96,7,4,9,6,4,24,132,8.0
Malaysia,Asia,194,171,56,52,86,179,15,5,2,2,4,1,192,2,6.0
North America,North America,159,153,34,27,98,136,23,5,4,0,9,4,155,4,0.0
Namibia,Africa,43,175,3,10,30,8,35,5,6,1,5,3,37,6,17.0
New Caledonia,Oceania,155,47,30,85,40,43,112,0,7,6,2,0,81,74,560.0
Niger,Africa,105,133,10,32,63,27,78,0,7,9,5,5,72,33,4.0
Nigeria,Africa,54,43,20,4,30,40,14,2,1,8,0,3,37,17,0.0
Nicaragua,North America,227,175,78,89,60,35,192,5,3,2,0,8,187,40,33.0
Netherlands,Europe,146,85,91,45,10,43,103,9,8,5,5,7,102,44,8.0
Norway,Europe,191,142,54,59,78,32,159,8,9,1,3,7,139,52,35.0
Nepal,Asia,78,52,26,5,47,65,13,0,1,2,1,2,1,77,3.0
Nauru,Oceania,97,94,71,8,18,81,16,1,0,6,9,7,29,68,7657.0
New Zealand,Oceania,244,103,94,68,82,0,244,5,4,8,4,5,69,175,48.0
Oman,Asia,211,45,87,84,40,62,149,9,1,6,3,8,45,166,46.0
Pakistan,Asia,187,42,65,60,62,55,132,9,4,9,2,1,19,168,1.0
Panama,North America,170,34,33,50,87,146,24,8,1,4,6,5,150,20,39.0
Peru,South America,127,182,8,79,40,109,18,4,0,7,8,3,73,54,4.0
Philippines,Asia,141,12,23,21,97,114,27,1,1,7,2,4,4,137,1.0
Palau,Oceania,89,48,26,0,63,57,32,4,7,4,6,1,29,60,4929.0
Papua New Guinea,Oceania,109,98,7,7,95,35,74,9,5,8,4,6,61,48,11.0
Poland,Europe,136,58,19,82,35,15,121,4,3,1,6,4,124,12,4.0
Puerto Rico,North America,181,17,61,57,63,142,39,5,6,4,1,3,135,46,56.0
"Korea, Dem. People's Rep.",Asia,118,71,16,72,30,67,51,1,7,9,6,0,109,9,5.0
Portugal,Europe,208,82,60,71,77,24,184,7,6,7,8,3,186,22,20.0
Paraguay,South America,91,2,21,50,20,40,51,5,4,0,8,8,89,2,13.0
French Polynesia,Oceania,169,195,31,97,41,56,113,8,1,1,7,4,148,21,552.0
Qatar,Asia,225,96,76,82,67,224,1,9,0,4,4,0,161,64,83.0
Romania,Europe,150,37,89,36,25,20,130,7,2,1,7,3,109,41,8.0
Russian Federation,Europe,93,142,56,5,32,81,12,6,9,3,9,7,88,5,1.0
Rwanda,Africa,166,102,66,11,89,67,99,5,8,2,2,2,122,44,12.0
Saudi Arabia,Asia,66,123,40,5,21,21,45,6,4,4,7,9,57,9,2.0
Sudan,Africa,119,140,34,75,10,98,21,8,8,8,1,1,80,39,3.0
Senegal,Africa,179,38,92,77,10,94,85,7,6,0,4,0,106,73,10.0
Singapore,Asia,156,127,69,25,62,137,19,0,5,9,8,9,44,112,28.0
Solomon Islands,Oceania,111,36,46,22,43,92,19,0,9,7,7,4,36,75,153.0
Sierra Leone,Africa,142,102,24,21,97,19,123,0,9,5,1,2,28,114,17.0
El Salvador,North America,132,95,51,49,32,87,45,6,8,7,9,5,73,59,21.0
San Marino,Europe,138,84,29,79,30,78,60,3,1,6,8,1,119,19,4100.0
Somalia,Africa,193,19,40,78,75,68,125,5,7,5,4,7,143,50,11.0
Serbia,Europe,132,18,37,48,47,113,19,7,5,2,7,4,25,107,20.0
South Sudan,Africa,109,134,2,13,94,29,80,3,5,5,9,1,80,29,10.0
Sao Tome and Principe,Africa,215,190,86,31,98,97,118,0,7,3,0,6,72,143,946.0
Suriname,South America,128,93,25,18,85,11,117,5,4,5,2,0,93,35,207.0
Slovak Republic,Europe,207,68,81,29,97,157,50,1,6,6,1,4,159,48,38.0
Slovenia,Europe,176,32,84,88,4,26,150,7,1,8,2,9,102,74,83.0
Sweden,Europe,139,62,60,58,21,99,40,8,0,6,8,4,12,127,13.0
Eswatini,Africa,196,183,38,70,88,171,25,7,4,2,5,5,106,90,163.0
Seychelles,Africa,171,0,76,19,76,140,31,9,9,9,9,4,29,142,1709.0
Syrian Arab Republic,Asia,164,106,37,68,59,129,35,3,5,3,3,3,68,96,7.0
Turks and Caicos Islands,North America,64,31,31,31,2,63,1,0,2,1,7,8,39,25,1400.0
Chad,Africa,147,118,39,38,70,93,54,0,4,3,9,6,70,77,8.0
Togo,Africa,222,23,47,84,91,176,46,9,0,7,1,6,39,183,25.0
Thailand,Asia,139,110,30,75,34,117,22,2,1,6,0,9,22,117,2.0
Tajikistan,Asia,165,30,55,43,67,137,28,4,7,0,7,5,75,90,17.0
Turkmenistan,Asia,230,21,76,94,60,129,101,4,1,6,0,0,206,24,36.0
Tonga,Oceania,168,16,93,51,24,48,120,9,5,6,8,1,17,151,1572.0
Trinidad and Tobago,North America,38,56,19,3,16,16,22,6,9,8,6,0,0,38,25.0
Tunisia,Africa,143,110,21,84,38,105,38,0,1,8,3,5,27,116,12.0
Turkiye,Asia,118,143,33,79,6,38,80,2,0,4,5,0,20,98,1.0
Tuvalu,Oceania,116,90,31,48,37,51,65,8,8,0,9,4,27,89,10255.0
Tanzania,Africa,216,132,88,92,36,145,71,5,0,5,2,3,47,169,3.0
Uganda,Africa,146,167,85,42,19,12,134,9,3,5,4,3,84,62,3.0
Ukraine,Europe,168,120,41,63,64,46,122,2,7,3,9,9,65,103,4.0
Uruguay,South America,155,148,83,52,20,0,155,1,0,2,5,2,61,94,45.0
United States,North America,114,146,6,94,14,100,14,8,2,0,7,1,91,23,0.0
Uzbekistan,Asia,253,143,87,99,67,8,245,2,3,8,2,0,151,102,7.0
St. Vincent and the Grenadines,North America,159,30,75,28,56,62,97,3,4,0,4,9,149,10,1530.0
"Venezuela, RB",South America,118,11,18,87,13,25,93,1,0,8,9,3,72,46,4.0
British Virgin Islands,North America,204,181,72,52,80,144,60,9,1,0,4,4,110,94,6517.0
Virgin Islands (U.S.),North America,188,150,58,89,41,0,188,5,1,9,2,6,144,44,1783.0
Viet Nam,Asia,265,35,98,89,78,74,191,3,3,0,2,6,44,221,3.0
Vanuatu,Oceania,168,172,96,50,22,8,160,5,5,5,3,8,59,109,514.0
Samoa,Oceania,114,147,26,68,20,50,64,1,1,4,6,0,54,60,513.0
Kosovo,Europe,168,144,85,20,63,81,87,9,5,1,8,2,72,96,95.0
"Yemen, Rep.",Asia,106,33,49,15,42,91,15,2,0,4,3,7,21,85,3.0
South Africa,Africa,215,81,85,33,97,48,167,1,5,7,2,9,207,8,4.0
Zambia,Africa,168,20,96,69,3,70,98,0,9,0,2,9,63,105,8.0
Zimbabwe,Africa,114,116,28,6,80,70,44,6,8,6,9,6,20,94,7.0
